11111111111111111111111111111
13022222222222222222222222031
10121212121212121212121212101
12222222222222222222222222221
12121212121212121212121212121
12222222222222222222222222221
12121212121212121212121212121
12222222222222222222222222221
12121212121212121212121212121
12222222222222222222222222221
12121212121212121212121212121
12222222222222222222222222221
12121212121212121212121212121
12222222222222222222222222221
12121212121212121212121212121
12222222222222222222222222221
12121212121212121212121212121
12222222222222222222222222221
12121212121212121212121212121
12222222222222222222222222221
12121212121212121212121212121
12222222222222222222222222221
10121212121212121212121212101
13022222222222222222222222031
11111111111111111111111111111