111111111
130000031
101212101
100222001
101212101
130000031
111111111